N:ITEM FESTA
T:100
S:15,17
D:0,0,0,0,0,0,0,0,0,0,0,0,0,0,0
D:0,0,0,0,0,3,0,0,0,0,0,0,2,2,0
D:0,0,0,0,0,3,3,0,0,0,0,0,3,2,0
D:0,3,0,0,0,0,0,0,0,2,0,0,3,0,0
D:0,3,0,0,0,0,3,3,0,3,2,3,0,0,0
D:0,3,0,0,0,0,3,0,0,3,3,3,3,2,0
D:0,2,3,0,0,0,2,2,0,3,0,0,0,2,0
D:0,2,2,2,2,2,2,3,3,0,0,0,0,2,0
D:0,0,0,0,0,2,0,3,0,2,0,0,0,0,0
D:0,2,0,0,0,0,3,3,2,2,2,2,2,2,0
D:0,2,0,0,0,3,0,2,2,0,0,0,3,2,0
D:0,2,3,3,3,3,0,0,3,0,0,0,0,3,0
D:0,0,0,3,2,3,0,3,3,0,0,0,0,3,0
D:0,0,3,0,0,2,0,0,0,0,0,0,0,3,0
D:0,2,3,0,0,0,0,0,3,3,0,0,0,0,0
D:0,2,2,0,0,0,0,0,0,3,0,0,0,0,0
D:0,0,0,0,0,0,0,0,0,0,0,0,0,0,0
C:11,13
H:3,3
