N:jail, jail, jail!
T:100
S:15,17
D:0,0,0,0,0,2,2,2,0,0,2,0,3,2,3
D:0,2,2,2,3,0,2,0,0,3,0,0,0,0,0
D:0,2,0,0,0,0,2,0,0,0,0,0,3,2,0
D:0,2,0,3,0,0,2,0,2,0,0,0,2,0,0
D:0,0,0,0,0,0,0,0,2,0,0,0,0,0,0
D:0,3,0,0,0,0,3,0,2,2,2,0,0,0,0
D:2,2,2,2,2,0,0,0,2,0,0,0,2,3,2
D:0,3,2,3,0,0,0,0,0,2,2,2,0,0,0
D:0,0,0,2,0,0,0,3,0,0,0,2,0,0,0
D:0,0,0,2,2,2,0,0,0,0,0,3,2,3,0
D:2,3,2,0,0,0,2,0,0,0,2,2,2,2,2
D:0,0,0,0,2,2,2,0,3,0,0,0,0,3,0
D:0,0,0,0,0,0,2,0,0,0,0,0,0,0,0
D:0,0,2,0,0,0,2,0,2,0,0,3,0,2,0
D:0,2,3,0,0,0,0,0,2,0,0,0,0,2,0
D:0,0,0,0,0,3,0,0,2,0,3,2,2,2,0
D:3,2,3,0,2,0,0,2,2,2,0,0,0,0,0
C:10,3
H:4,13
