N:trap fest
T:100
S:15,17
D:2,0,0,0,3,0,0,3,0,0,3,3,2,2,2
D:0,2,2,2,2,2,2,2,0,0,0,0,0,3,2
D:0,2,0,0,3,0,0,2,2,0,0,0,0,3,2
D:0,2,0,0,0,0,3,0,0,0,0,0,0,0,0
D:0,2,2,2,0,0,0,0,0,2,2,0,0,0,0
D:0,0,0,0,3,0,0,0,3,0,0,0,0,3,2
D:2,0,0,2,0,2,0,2,0,0,2,0,0,3,0
D:0,3,0,0,0,0,2,0,2,0,2,0,0,0,2
D:0,3,2,2,2,0,0,3,0,0,2,2,2,3,0
D:2,0,0,0,2,0,2,0,2,0,0,0,0,3,0
D:0,3,0,0,2,0,0,2,0,2,0,2,0,0,2
D:2,3,0,0,0,0,3,0,0,0,3,0,0,0,0
D:0,0,0,0,2,2,0,0,0,0,0,2,2,2,0
D:0,0,0,0,0,0,0,0,3,0,0,0,0,2,0
D:2,3,0,0,0,0,2,2,0,0,3,0,0,2,0
D:2,3,0,0,0,0,0,2,2,2,2,2,2,2,0
D:2,2,2,3,3,0,0,3,0,0,3,0,0,0,2
C:11,2
H:3,14
