N:02
T:120
S:21,17
D:0,0,0,0,0,3,0,0,3,0,0,0,0,0,3,3,0,0,0,0,0
D:0,2,2,0,0,0,2,2,0,0,0,0,3,2,0,0,0,0,0,0,0
D:0,2,0,3,0,0,0,0,0,0,0,0,0,0,0,0,0,0,0,0,0
D:0,0,3,3,0,0,0,0,0,0,2,2,0,0,0,0,3,0,0,0,0
D:0,3,3,0,0,0,0,0,2,2,2,0,0,0,0,0,3,0,0,0,0
D:3,3,0,0,0,0,0,0,2,0,0,0,0,0,0,3,0,0,0,0,3
D:0,0,0,0,0,0,0,0,0,0,0,0,0,3,3,0,0,0,0,0,3
D:0,0,3,0,0,0,3,0,0,0,0,0,3,0,0,0,0,0,2,2,0
D:0,2,3,0,0,0,0,3,0,0,3,0,0,3,0,0,0,0,3,2,0
D:0,2,2,0,0,0,0,0,3,0,0,0,0,0,3,0,0,0,3,0,0
D:3,0,0,0,0,0,3,3,0,0,0,0,0,0,0,0,0,0,0,0,0
D:3,0,0,0,0,3,0,0,0,0,0,0,2,0,0,0,0,0,0,3,3
D:0,0,0,0,3,0,0,0,0,0,2,2,2,0,0,0,0,0,3,3,0
D:0,0,0,0,3,0,0,0,0,2,2,0,0,0,0,0,0,3,3,0,0
D:0,0,0,0,0,0,0,0,0,0,0,0,0,0,0,0,0,3,0,2,0
D:0,0,0,0,0,0,0,2,3,0,0,0,0,2,2,0,0,0,2,2,0
D:0,0,0,0,0,3,3,0,0,0,0,0,3,0,0,3,0,0,0,0,0
C:18,1
H:2,15
