N:06
T:120
S:21,17
D:0,0,0,0,0,0,0,0,0,0,0,0,0,0,0,0,3,0,0,0,0
D:0,3,0,0,0,0,3,0,0,0,3,0,0,0,0,0,0,0,0,0,0
D:0,0,0,2,0,0,3,0,3,0,3,0,0,0,0,0,0,0,0,0,0
D:0,0,2,2,0,0,3,0,3,0,3,0,0,2,0,2,0,2,2,2,0
D:0,0,0,0,0,0,0,3,0,3,0,0,0,2,0,2,0,2,0,3,0
D:0,0,0,0,0,0,0,0,0,0,0,0,0,0,2,0,0,2,0,0,0
D:0,3,0,0,0,0,0,0,0,0,0,0,0,2,0,2,0,2,2,2,0
D:0,2,2,2,0,0,0,0,0,3,0,3,0,2,0,2,0,2,0,3,0
D:0,0,0,2,0,0,0,0,0,0,3,0,0,0,0,0,0,2,0,0,0
D:0,3,0,2,0,2,0,2,0,3,0,3,0,0,0,0,0,2,2,2,0
D:0,2,2,2,0,2,0,2,0,0,0,0,0,0,0,0,0,0,0,3,0
D:0,0,0,2,0,0,2,0,0,0,0,0,0,0,0,0,0,0,0,0,0
D:0,3,0,2,0,2,0,2,0,0,0,3,0,3,0,0,0,0,0,0,0
D:0,2,2,2,0,2,0,2,0,0,3,0,3,0,3,0,0,2,2,0,0
D:0,0,0,0,0,0,0,0,0,0,3,0,3,0,3,0,0,2,0,0,0
D:0,0,0,0,0,0,0,0,0,0,3,0,0,0,3,0,0,0,0,3,0
D:0,0,0,0,3,0,0,0,0,0,0,0,0,0,0,0,0,0,0,0,0
C:1,15
H:19,1
