N:08
T:120
S:21,17
D:3,0,0,0,0,0,0,0,0,0,0,0,0,0,0,0,0,0,0,0,0
D:0,3,0,0,3,0,0,0,0,0,0,3,0,0,0,0,0,2,2,2,0
D:0,0,0,0,0,0,0,0,3,0,0,0,2,2,0,0,0,2,2,2,0
D:0,0,0,0,0,0,0,3,0,0,0,0,3,0,3,0,0,2,2,2,0
D:0,2,0,0,0,0,0,0,0,0,2,0,0,0,0,0,3,0,0,0,0
D:0,0,0,3,0,0,0,3,0,0,3,0,0,3,0,0,3,3,2,0,0
D:0,3,2,3,0,0,0,0,0,0,0,0,0,0,0,0,0,0,0,0,0
D:0,3,0,0,0,0,0,0,0,0,0,0,0,0,0,0,3,2,0,0,0
D:0,0,0,0,0,0,0,3,0,0,3,0,0,3,0,0,0,0,0,0,0
D:0,0,0,2,3,0,0,0,0,0,0,0,0,0,0,0,0,0,0,3,0
D:0,0,0,0,0,0,0,0,0,0,0,0,0,0,0,0,0,3,2,3,0
D:0,0,2,3,3,0,0,3,0,0,3,0,0,3,0,0,0,3,0,0,0
D:0,0,0,0,3,0,0,0,0,0,2,0,0,0,0,0,0,0,0,2,0
D:0,2,2,2,0,0,3,0,3,0,0,0,0,3,0,0,0,0,0,0,0
D:0,2,2,2,0,0,0,2,2,0,0,0,3,0,0,0,0,0,0,0,0
D:0,2,2,2,0,0,0,0,0,3,0,0,0,0,0,0,3,0,0,3,0
D:0,0,0,0,0,0,0,0,0,0,0,0,0,0,0,0,0,0,0,0,3
C:16,13
H:4,3
